a	a
b	b
d	d
d͡ʒ	dZ
e	e
f	f
i	i
j	j
k	k
kʷ	kw
k͡p	kp
l	l
m	m
n	n
o	o
p	p
s	s
t	t
t͡ʃ	tS
u	u
v	v
w	w
z	z
ŋ	N
ŋʷ	Nw
ɔ	O
ɡ	g
ɡʷ	gw
ɡ͡ɓ	gbE
ɣ	G
ɦ	hv
ɪ	I
ɲ	J
ɹ	rr
ʃ	S
ʊ	U
