a	a
b	b
d	d
d͡ʒ	dZ
e	e
f	f
i	i
j	j
k	k
kʷ	k_w
k͡p	kp
l	l
m	m
n	n
o	o
p	p
s	s
t	t
t͡ʃ	tS
u	u
v	v
w	w
z	z
ŋ	N
ŋʷ	N_w
ɔ	O
ɡ	g
ɡʷ	g_w
ɡ͡ɓ	gb_<
ɣ	G
ɦ	h\
ɪ	I
ɲ	J
ɹ	r\
ʃ	S
ʊ	U
